111111
1C0011
1000E1
100011
111111