111111
1C0011
1000E1
1P0001
111111