11111111
1C010111
10010E01
1P001111
11111111