111111
100011
1000E1
1P0011
111111