111111
1C0011
1000E1
1P0011
111111