111111
1C0011
100001
1P0011
111111