11111111
1C010111
100C0E01
1P001111
11111111