111111
1C0011
10C0E1
1P0011
111111