111111
1C001001
1000E1
1P00101
111111