111111
1C0P11
1000E1
1P0011
111111