111111
1CE011
1000E1
1P0011
111111